10,10,10,19,12,13,10,10,10
10,10,10,18,11,14,10,10,10
10,10,10,18,11,14,10,10,10
10,10,10,18,11,14,10,10,10
10,10,10,18,11,14,10,10,10
10,10,10,18,11,14,10,10,10
10,10,10,18,11,14,10,10,10
10,10,10,18,11,14,10,10,10
10,10,10,17,16,15,10,10,10
