10,20,10,10,20,10,10,20,10
19,11,12,12,11,12,12,11,13
18,11,11,11,11,11,11,11,14
18,11,11,11,11,11,11,11,14
17,16,16,11,11,11,16,16,15
10,10,10,18,11,14,10,10,10
10,10,10,18,11,14,10,10,10
10,10,10,18,11,14,10,10,10
10,10,10,17,16,15,10,10,10
