19,12,12,12,12,12,12,12,13
18,11,11,11,11,11,11,11,14
18,11,11,11,11,11,11,11,14
18,11,11,11,11,11,11,11,14
18,11,11,11,11,11,11,11,14
18,11,11,11,11,11,11,11,14
18,11,11,11,11,11,11,11,14
18,11,11,11,11,11,11,11,14
17,16,16,16,16,16,16,16,15
